000000000000000000000000000000010000000000000000011111111111
000000000000000000000000000000010000000000000000011111111111
000000000000000000000000000000011100000000000000000011111111
000000000000000000000000000000011100000000000000000011111111
000000001110001110000000000000010000000000000000000000000000
000000001110001110000000000000010000000110000001100000000000
000000001110000000000000000000010000000000000001100011111111
000000000100000000000000000000010000000000000000000011111111
001100000000000000000000000000010000000000000000000011111111
001100000000000000001100000000010000000000000000000011111111
000000000000000000001100000000010000000000000000000011111111
000000000000000000000000000000010000000000000000000000000000
000000000000000000110000000000010000011000000000000000000000
000000000001110000111100000000010000001100000000000000000000
000000000001110000001100000000010000001100000000000000000000
000000000000000000001100000000010000000000000000000000000000
000000000000000000001100000000010000000000000000000000000000
000000000000000111000000000000010000000000000000000000000000
000000000000000111000000000000010000000000000000000000000000
000000000000000111000000000000010000000000000000000000011000
000001110000000000000000000000010000000000000000000000011000
000001110000000000000000000000010000000000000000011000000001
000000000000000000000000000000010000000000000000011000000001
000000000000110000000000000000000000000000000000001100000010
000000000000110000000000000000000000000000000000001100000100
000000000000000000000000000000000000000000000000000000000000
000000000000000000000000000000000000000000000000000000000000
000000000000000000000000000000010000000000000000000000000000
000000000000000000000000000000010000000000000000000000000000
000000000000000000000000000000010000000000000000000000000000
000000000000000000000000000000010000000000000000000000000000
000000000000000000000000000000010000000000000000000000000000
000000000000000000000000000000010000000000000000000000000000
000000000000000000000000000000010000000000000000000000000000